■■■■■■■■■■■■■■■■■■■■■■■■■■■■■■■■■■■■■■■■
■■■■■■■■■■■■■■■■■■■■■■■■■■■■■■■■■■■■■■■■
■■■■■■■■■■■■■■■■■■■■■■■■■■■■■■■■■■■■■■■■
■■■■■■┌──────────────────────────┐■■■■■■
■■■■■■├..........................┤■■■■■■
■■■■■■├.╔══╗.╔╗.╔══════╗.╔╗.╔══╗.┤■■■■■■
■■■■■■├.┤■■├.┤├.┤┌────┐├.┤├.┤■■├.┤■■■■■■
■■■■■■├.╚──╝.┤├.┤├....┤├.┤├.╚──╝.┤■■■■■■
■■■■■■├......┤├.┤├.╔╗.┤├.┤├......┤■■■■■■
■■■■■■├.╔╗.╔═┘├.┤├.┤├.┤├.┤└═╗.╔╗.┤■■■■■■
■■■■■■├.┤├.╚─┐├.╚╝.┤├.╚╝.┤┌─╝.┤├.┤■■■■■■
■■■■■■├.┤├...┤├....┤├....┤├...┤├.┤■■■■■■
■■■■■■├.┤└═╗.┤├.╔══┘└══╗.┤├.╔═┘├.┤■■■■■■
■■■■■■├.╚──╝.╚╝.╚──────╝.╚╝.╚──╝.┤■■■■■■
■■■■■■├..........................┤■■■■■■
■■■■■■└═╗.╔╗.╔╗.╔══════╗.╔╗.╔╗.╔═┘■■■■■■
■■■■■■┌─╝.┤├.┤├.┤■■■■■■├.┤├.┤├.╚─┐■■■■■■
■■■■■■├...┤├.┤├.┤■■■■■■├.┤├.┤├...┤■■■■■■
■■■■■■├.╔═┘├.┤├.┤■■■■■■├.┤├.┤└═╗.┤■■■■■■
■■■■■■├.╚─┐├.┤├.╚──────╝.┤├.┤┌─╝.┤■■■■■■
■■■■■■├...┤├.┤├..........┤├.┤├...┤■■■■■■
■■■■■■└═╗.┤├.┤└══╗.╔╗.╔══┘├.┤├.╔═┘■■■■■■
■■■■┌───╝.╚╝.╚───╝.┤├.╚───╝.╚╝.╚──┐■■■■■
■■■■├S.............┤├............s┤■■■■■
■■■■└═══╗.╔╗.╔╗.╔══┘└══╗.╔╗.╔╗.╔══┘■■■■■
■■■■■■┌─╝.┤├.┤├.╚──────╝.┤├.┤├.╚─┐■■■■■■
■■■■■■├...┤├.┤├..........┤├.┤├...┤■■■■■■
■■■■■■├.╔═┘├.┤└══╗.╔╗.╔══┘├.┤└═╗.┤■■■■■■
■■■■■■├.╚──╝.┤┌──╝.┤├.╚──┐├.╚──╝.┤■■■■■■
■■■■■■├......┤├....┤├....┤├......┤■■■■■■
■■■■■■├.╔══╗.┤├.╔══┘└══╗.┤├.╔══╗.┤■■■■■■
■■■■■■├.╚──╝.╚╝.╚──────╝.╚╝.╚──╝.┤■■■■■■
■■■■■■├..........................┤■■■■■■
■■■■■■└══════════════════════════┘■■■■■■
■■■■■■■■■■■■■■■■■■■■■■■■■■■■■■■■■■■■■■■■
■■■■■■■■■■■■■■■■■■■■■■■■■■■■■■■■■■■■■■■■