■■■■■■■■■■■■■■■■■■■■■■■■■■■■■■■■■■■■■■■■
■■■■■■■■■■■■■■■■■■■■■■■■■■■■■■■■■■■■■■■■
■■■■■■■■■■■■■■■■■■■■■■■■■■■■■■■■■■■■■■■■
■■■■■■┌──────┐┌──────────┐┌──────┐■■■■■■
■■■■■■├......┤├..........┤├......┤■■■■■■
■■■■■■├.╔══╗.┤├.╔══════╗.┤├.╔══╗.┤■■■■■■
■■■■■■├.┤┌─╝.╚╝.┤┌────┐├.╚╝.╚─┐├.┤■■■■■■
■■■■■■├.┤├......┤├....┤├......┤├.┤■■■■■■
■■■■■■├.┤├.╔══╗.┤├.╔╗.┤├.╔══╗.┤├.┤■■■■■■
■■■■■■├.┤├.┤■■├.┤├.┤├.┤├.┤■■├.┤├.┤■■■■■■
■■■■┌─╝.╚╝.╚──╝.╚╝.┤├.╚╝.╚──╝.╚╝.╚─┐■■■■
■■■■├S.............┤├.............s┤■■■■
■■■■└═╗.╔══╗.╔╗.╔══┘└══╗.╔╗.╔══╗.╔═┘■■■■
■■■■■■├.┤┌─╝.┤├.╚──────╝.┤├.╚─┐├.┤■■■■■■
■■■■■■├.┤├...┤├..........┤├...┤├.┤■■■■■■
■■■■■■├.┤├.╔═┘├.╔══════╗.┤└═╗.┤├.┤■■■■■■
■■■■■■├.╚╝.╚──╝.┤■■■■■■├.╚──╝.╚╝.┤■■■■■■
■■■■■■├.........┤■■■■■■├.........┤■■■■■■
■■■■■■├.╔══╗.╔╗.┤■■■■■■├.╔╗.╔══╗.┤■■■■■■
■■■■■■├.┤┌─╝.┤├.╚──────╝.┤├.╚─┐├.┤■■■■■■
■■■■■■├.┤├...┤├..........┤├...┤├.┤■■■■■■
■■■■■■├.┤├.╔═┘└══╗.╔╗.╔══┘└═╗.┤├.┤■■■■■■
■■■■■■├.╚╝.╚─────╝.┤├.╚─────╝.╚╝.┤■■■■■■
■■■■■■├............┤├............┤■■■■■■
■■■■■■├.╔══╗.╔╗.╔══┘└══╗.╔╗.╔══╗.┤■■■■■■
■■■■■■├.╚──╝.┤├.╚──────╝.┤├.╚──╝.┤■■■■■■
■■■■■■├......┤├..........┤├......┤■■■■■■
■■■■■■├.╔╗.╔═┘├.╔══════╗.┤└═╗.╔╗.┤■■■■■■
■■■■■■├.┤├.╚─┐├.╚──┐┌──╝.┤┌─╝.┤├.┤■■■■■■
■■■■■■├.┤├...┤├....┤├....┤├...┤├.┤■■■■■■
■■■■■■├.┤└═╗.┤├.╔╗.┤├.╔╗.┤├.╔═┘├.┤■■■■■■
■■■■■■├.╚──╝.╚╝.┤├.╚╝.┤├.╚╝.╚──╝.┤■■■■■■
■■■■■■├.........┤├....┤├.........┤■■■■■■
■■■■■■└═════════┘└════┘└═════════┘■■■■■■
■■■■■■■■■■■■■■■■■■■■■■■■■■■■■■■■■■■■■■■■
■■■■■■■■■■■■■■■■■■■■■■■■■■■■■■■■■■■■■■■■