■■■■■■■■■■■■■■■■■■■■■■■■■■■■■■■■■■■■■■■■
■■■■■■┌──────┐┌──────────┐┌──────┐■■■■■■
■■■■■■├......┤├..........┤├......┤■■■■■■
■■■■■■├.╔══╗.┤├.╔══════╗.┤├.╔══╗.┤■■■■■■
■■■■■■├.┤┌─╝.╚╝.┤┌────┐├.╚╝.╚─┐├.┤■■■■■■
■■■■■■├.┤├..+..+┤├....┤├+..+..┤├.┤■■■■■■
■■■■■■├.┤├.╔══╗.┤├.╔╗.┤├.╔══╗.┤├.┤■■■■■■
■■■■■■├.┤├.┤■■├.┤├.┤├.┤├.┤■■├.┤├.┤■■■■■■
■■■■■■├.╚╝.╚──╝.╚╝.┤├.╚╝.╚──╝.╚╝.┤■■■■■■
■■■■■■├+..+....+...┤├...+....+..+┤■■■■■■
■■■■■■├.╔╗.╔══╗.╔══┘└══╗.╔══╗.╔╗.┤■■■■■■
■■■■■■├.┤├.╚─┐├.╚──────╝.┤┌─╝.┤├.┤■■■■■■
■■■■■■├.┤├...┤├+........+┤├...┤├.┤■■■■■■
■■■■■■├.┤└═╗.┤├.╔══════╗.┤├.╔═┘├.┤■■■■■■
■■■■■■├.╚──╝.╚╝.┤■■■■■■├.╚╝.╚──╝.┤■■■■■■
■■■■■■├..+.....+┤■■■■■■├+.....+..┤■■■■■■
■■■■■■└═╗.╔═══╗.┤■■■■■■├.╔═══╗.╔═┘■■■■■■
■■■■┌───╝.╚──┐├.╚──────╝.┤┌──╝.╚───┐■■■■
■■■■├S...+...┤├+........+┤├...+...s┤■■■■
■■■■└═╗.╔══╗.┤├.╔══════╗.┤├.╔══╗.╔═┘■■■■
■■■■■■├.┤┌─╝.╚╝.╚──┐┌──╝.╚╝.╚─┐├.┤■■■■■■
■■■■■■├.┤├..+..+...┤├...+..+..┤├.┤■■■■■■
■■■■■■├.┤├.╔═════╗.┤├.╔═════╗.┤├.┤■■■■■■
■■■■■■├.╚╝.╚────┐├.╚╝.┤┌────╝.╚╝.┤■■■■■■
■■■■■■├+..+.....┤├+..+┤├.....+..+┤■■■■■■
■■■■■■├.╔╗.╔══╗.┤├.╔╗.┤├.╔══╗.╔╗.┤■■■■■■
■■■■■■├.┤├.╚─┐├.╚╝.┤├.╚╝.┤┌─╝.┤├.┤■■■■■■
■■■■■■├.┤├...┤├+...┤├...+┤├...┤├.┤■■■■■■
■■■■■■├.┤└═╗.┤├.╔══┘└══╗.┤├.╔═┘├.┤■■■■■■
■■■■■■├.╚──╝.╚╝.╚──────╝.╚╝.╚──╝.┤■■■■■■
■■■■■■├.....+..+........+..+.....┤■■■■■■
■■■■■■╚══════════════════════════╝■■■■■■
■■■■■■■■■■■■■■■■■■■■■■■■■■■■■■■■■■■■■■■■